20
12
o------------------o
|   3              |
| o----o o------oo |
| |          G  |  |
|G| o--------o  | S|
| | |    L   |  | o|
| | |        | o|1o|
| | o---o o--o  |  |
| |            B|  |
| o-------------oo |
| 2        G       |
o------------------o